##########
###  @ ###
###    ###
####  ####
#       X#
#      ###
# ##   ###
#X##   ###
#       X#
##########